b,b,b,b,b,b,b,w,w,w,w,w,b,b,b,b,b,b,b,b
b,b,b,b,b,b,b,w,s,s,s,w,b,b,b,b,b,b,b,b
b,w,w,w,w,w,w,w,f,k,f,w,w,b,b,b,b,b,b,b
b,w,s,s,s,s,s,s,f,f,f,s,w,b,b,b,b,b,b,b
b,w,f,f,f,f,f,f,f,f,f,f,w,b,b,b,b,b,b,b
b,w,f,f,f,f,m,f,f,f,f,f,w,b,b,b,b,b,b,b
b,w,f,f,f,f,f,f,f,f,f,f,w,b,b,b,b,b,b,b
b,w,r,f,f,f,f,f,f,f,f,e,w,b,b,b,b,b,b,b
b,s,w,w,w,w,w,w,w,w,w,w,s,b,b,b,b,b,b,b
b,b,s,s,s,s,s,s,s,s,s,s,b,b,b,b,b,b,b,b
b,b,b,b,b,b,b,b,b,b,b,b,b,b,b,b,b,b,b,b
b,b,b,b,b,b,b,b,b,b,b,b,b,b,b,b,b,b,b,b
