b,b,b,b,b,b,b,b,b,b,b,b,b,b,b,b,b,b,b,b
b,w,w,w,w,w,w,w,w,w,w,w,w,w,w,w,w,w,w,b
b,w,s,s,s,s,s,s,s,s,s,s,s,s,s,s,s,s,w,b
b,w,f,f,f,t,t,t,t,t,t,t,t,t,t,f,f,f,w,b
b,w,f,f,f,t,f,f,f,f,f,f,f,f,t,f,f,f,w,b
b,w,w,w,w,w,f,f,f,f,f,f,k,f,w,f,f,f,w,b
b,w,f,f,f,t,f,f,f,f,f,g,f,f,t,f,f,f,w,b
b,w,f,f,f,t,f,f,f,f,f,f,f,f,t,f,f,f,w,b
b,w,f,f,w,w,f,f,f,f,f,f,f,f,w,f,f,e,w,b
b,w,r,f,w,t,t,t,t,t,t,t,t,t,w,f,f,f,w,b
b,w,w,w,w,w,w,w,w,w,w,w,w,w,w,w,w,w,w,b
b,s,s,s,s,s,s,s,s,s,s,s,s,s,s,s,s,s,s,b
