b,b,b,b,b,b,b,b,b,b,b,b,b,b,b,b,b,b,b,b
b,b,b,b,b,b,b,b,b,b,b,b,b,b,b,b,b,b,b,b
b,w,w,w,w,w,w,w,w,b,b,b,b,b,b,b,b,b,b,b
b,w,s,s,s,s,s,s,w,b,b,b,b,b,b,b,b,b,b,b
b,w,f,f,f,f,f,f,w,b,b,b,b,b,b,b,b,b,b,b
b,w,f,f,f,f,f,f,w,b,b,b,b,b,b,b,b,b,b,b
b,w,w,w,w,w,w,w,w,b,b,b,b,b,b,b,b,b,b,b
b,s,s,s,s,s,s,s,s,b,b,b,b,b,b,b,b,b,b,b
b,b,b,b,b,b,b,b,b,b,b,b,b,b,b,b,b,b,b,b
b,b,b,b,b,b,b,b,b,b,b,b,b,b,b,b,b,b,b,b
b,b,b,b,b,b,b,b,b,b,b,b,b,b,b,b,b,b,b,b
b,b,b,b,b,b,b,b,b,b,b,b,b,b,b,b,b,b,b,b
