b,b,b,b,b,b,b,b,b,b,b,b,b,b,b,b,b,b,b,b
b,b,b,b,b,b,b,b,b,b,b,b,b,b,b,b,b,b,b,b
b,b,b,b,b,b,b,b,b,b,b,b,b,b,b,b,b,b,b,b
b,w,w,w,w,w,w,w,w,w,w,w,w,w,w,w,w,w,w,b
b,w,s,s,s,s,s,s,s,s,s,s,s,s,s,s,s,s,w,b
b,w,f,f,f,f,f,f,f,f,f,g,f,f,f,f,f,f,w,b
b,w,r,f,f,f,f,f,f,f,f,f,f,f,f,f,f,e,w,b
b,w,w,w,w,w,w,f,f,w,w,w,w,w,w,w,w,w,w,b
b,s,s,s,s,s,w,f,f,f,k,w,s,s,s,s,s,s,s,b
b,b,b,b,b,b,w,f,f,f,f,w,b,b,b,b,b,b,b,b
b,b,b,b,b,b,w,w,w,w,w,w,b,b,b,b,b,b,b,b
b,b,b,b,b,b,s,s,s,s,s,s,b,b,b,b,b,b,b,b
