b,b,b,b,b,b,b,b,b,b,b,b,b,b,b,b,b,b,b,b
b,b,w,w,w,w,w,w,w,w,w,w,w,w,w,w,w,w,b,b
b,w,s,s,s,s,s,s,s,s,s,s,s,s,s,s,s,s,w,b
b,w,f,f,f,f,f,f,f,f,f,f,w,f,f,f,f,f,w,b
b,w,f,f,f,f,f,f,f,f,f,f,w,k,f,f,f,f,w,b
b,w,f,f,f,f,f,f,f,f,f,f,g,f,f,f,f,f,w,b
b,w,f,f,f,f,f,f,f,f,f,f,f,f,f,f,f,f,w,b
b,w,f,r,f,f,f,f,f,f,f,f,g,f,f,f,e,f,w,b
b,w,f,f,f,f,f,f,f,f,f,f,w,f,f,f,f,f,w,b
b,w,f,f,f,f,f,f,f,f,f,f,w,f,f,f,f,f,w,b
b,w,w,w,w,w,w,w,w,w,w,w,w,w,w,w,w,w,w,b
b,s,s,s,s,s,s,s,s,s,s,s,s,s,s,s,s,s,s,b
